#####################################
#                                   #
# ########### ######### ########### #
# ####        #########        #### #
#  ##  ###### ######### ######  ##  #
#  ##  #                     #  ##  #
#  ##  # ################### #  ##  #
#  ##  #          #          #  ##  #
#        ## ##### # ##### ##        #
# ## ### ##     # # #     ## ### ## #
# ##  #      #  #   #  #      #  ## #
#     # # ## #         # ## # #     #
# ##  # # ## # ### ### # ## # #  ## #
# ##  # # ## # #     # # ## # #  ## #
#       ###### #     # ######       #
#       ###### #     # ######       #
# ##  # # ## # #     # # ## # #  ## #
# ##  # # ## # ####### # ## # #  ## #
#     # # ## #         # ## # #     #
# ##  #      #  #   #  #      #  ## #
# ## ### ##     # # #     ## ### ## #
#        ## ##### # ##### ##        #
#  ##  #          #          #  ##  #
#  ##  # ################### #  ##  #
#  ##  #                     #  ##  #
#  ##  ###### ######### ######  ##  #
# ####        #########        #### #
# ########### ######### ########### #
#                                   #
#####################################